 ######
 #    #
##@$.$#
#    .#
#######